{   
    "WBC"   :   "",
    "NE%"   :   "",
    "LY%"   :   "",
    "MO%"   :   "",
    "EO%"   :   "",
    "AB%"   :   "",
    "NE#"   :   "",
    "LY#"   :   "",
    "MO#"   :   "",
    "EO#"   :   "",
    "BA#"   :   "",
    "RBC"   :   "",
    "HGB"   :   "",
    "Hct"   :   "",
    "MCV"   :   "",
    "MCH"   :   "",
    "MCHC"  :   "",
    "RDW"   :   "",
    "plt"   :   "",
    "MPV"   :   "",
    "Pct"   :   "",
    "PDW"   :   ""
}   